#############
#...........#
#.#.#.*.#.#.#
#...........#
#.#.#.#.#.#.#
#...........#
#.*.#.#.#.#.#
#...*.......#
#.#.#.#.#.#.#
#...........#
#############