############################
#..........................#
#..........................#
#..............#...........#
#......#...................#
#..........................#
#..........................#
#..........................#
#..........................#
#..........................#
#..........................#
#..........................#
#..........................#
############################
