####################
#..................#
#..................#
#..................#
#..................#
#..................#
#..................#
#......*...........#
#...........*......#
#...*..............#
#..................#
#.....*............#
#..................#
#...........*......#
#.....*....*.......#
#..................#
#...........*......#
#..................#
#..................#
#################### 