############################
#..........................#
#..........................#
#..............#...........#
#......#...................#
#..............#...........#
#..........................#
#.............#............#
#..........................#
#........#.................#
#..........................#
#..........................#
#..........................#
############################
