###############
#.............#
#.#.#.#.#.#.#.#
#...*.........#
#.#.#.#.#.#.#.#
#.............#
#.#.#.#.*.#.#.#
#..*...*...*..#
#.#.*.#.#.#.#.#
#.......*.....#
#.#.#.#.#.#.#.#
#.....*.......#
###############